1500
wwwwwwwwwwwwwwwwwwwwwwwwwwwwwwwwwwwwwwwwwwwwwwwwwwwwwwwwww
wGGDGGGGWWWGGGGGGGGGGGGGGGGGGGGGGGGGGGGGGGGGGGGGGGGGGGGGGw
wGGDGGGGWWWGGGGGGGGGGGGGGGGGGGGGGGGGGGGGGGGGGGGGGGGGGGGGGw
wGGDGGGGGGGGGGGGGGGGGGGGGGGGGGGGGGGGGGGGGGGGGGGGGGGGGGGGGw
wGGDDDDDDDDDDDDDDDDDDDDDDDDDDDDDDDDDDDDDDDDDDGGGGGGGGGGGGw
wGGDDDDDDDDDDDDDDDDDDDDDDDDDDDDDDDDDDDDDDDDDDGGGGGGGGGGGGw
wGGGGGGGGGGGGGGGGGGGGGGGGGGGGDGGGGGGGGGGGGGDDGGGGGGGGGGGGw
wGGGGGGGGWWWWWWWWWGGGGGGGGGGGDGGGGGGGGGGGGGDDGGGGGGGGGGGGw
wGGGGGGGGWGGGGGGGWGGGGGGGGGGGDGGGGGGGGGGGGGDDGGGGGGGGGGGGw
wGGGGGGGGWGDDDDDGGGGGGGGGGGGGDGGGGGGGGGGGGGDDGGGGGGGGGGGGw
wGGGGGGGGWGDDDDDDDDDDDDDDDDDDDDDDDDDDDDDDDDDDGGGGGGGGGGGGw
wGGGGGGGGWGDDDDDGGGGGGGGGGGGGDGGGGGGGGGGGGGDDGGGGGGGGGGGGw
wGGGGGGGGWGGGGGGGWGGGGGGGGGGGDGGGGGGGGGGGGGDDGGGGGGGGGGGGw
wGGGGGGGGWWWWWWWWWGGGGGGGGGGGDGGGGGGGGGGGGGDDGGGGGGGGGGGGw
wGGGGGGGGGGGGGGGGGGGGGGGGGGGGDGGGGGGGGGGGGGDDGGGGGGGGGGGGw
wGGGGGGGGGGGGGGGGGGGGGGGGGGGGDGGGGGGGGwwwwDDDDwwwwGGGGGGGw
wGGGGGGGGGGGGGGGGGGGGGGGGGGGGDGGGGGGGGwDDDDDDDDDDwGGGGGGGw
wGGGGGGGGGGGGGGGGGGGGGGGGGGGGDGGGGGGGGwDDDDDDDDDDwGGGGGGGw
wGGGGGGGGGGGGGGGGGGGGGGGGGGGGDGGGGGGGGwDDDDDDDDDDwGGGGGGGw
wGGGGGGGGGGGGGGGGGGGGGGGGGGGGDGGGGGGGGwDDDDDDDDDDwGGGGGGGw
wGGGGGGGGGGGGGGGGGGGGGGGGGGGGDGGGGGGGGwDDDDDDDDDDwGGGGGGGw
wGGGGGGGGGGGGGGGGGGGGGGGGGGGGDGGGGGGGGwwwwwwwwwwwwGGGGGGGw
wGGGGGGGGGGGGGGGGGGGGGGGGGGGGDGGGGGGGGGGGGGGGGGGGGGGGGGGGw
wGGGGGGGGGGGGGGGGGGGGGGGGGGGGDGGGGGGGGGGGGGGGGGGGGGGGGGGGw
wwwwwwwwwwwwwwwwwwwwwwwwwwwwwwwwwwwwwwwwwwwwwwwwwwwwwwwwww